.! This map tries to find a non-existent file
..Here we go!
NO res/i_am_a_dummy.bin

R 800 600

F 40, 40, 40
C 70, 70, 70

SO res/wall_s.xpm
WE res/wall_w.xpm
EA res/wall_e.xpm
S res/spr_tex_a.xpm

111111111
1       1
1       1
1       1
1   1   1
1       1
1   N   1
1       1
111111111
